#
# Resource file
#
deleted=已删除
notfound=没有对应数据存在
invalidname=名字不正确
editthispage==编辑该页面
admineditthispage=编辑该页面（需要密码）
cantchange=不可修改该页面
newpagename=新建页面
touch=更新时间戳
savebutton=保存
createbutton=创建
frozenbutton=冻结
notfrozenbutton=不冻结
frozenpassword=密码
passworderror=密码错误
changepasswordbutton=修改密码
oldpassword=现有密码
newpassword=新密码
newpassword2=新密码(确认用)
passwordmismatcherror=新密码和确认密码不一致
passwordchanged=密码修改成功
changepassword=修改密码
success=完成
passwordneeded=冻结页面操作需要密码
saved=保存成功
continuereading=请按继续按钮: 
searchthispage=检索该页面
recentchangesbutton=刷新履历
indexbutton=一览
createbutton=创建
editbutton=编辑
admineditbutton=冻结
yourname=你的名字:
commentbutton=追加注释
difftitle=显示比较结果
diffnotice=<ul><li>最终修改中追加的行是<b class="added">这样</b>显示的</li><li>最终修改中被删除的行是<s class="deleted">这样</s>显示的</li></ul><hr />
diffbutton=比较
rssbutton=RSS
previewtitle=预览
previewnotice=<p>请确认以下的预览结果，满意的话请按下面的保存按钮</p><hr />
previewempty=<p>(页面内容为空。如果保存的话，该页面将被<b>删除</b>。)</p>
previewbutton=预览
bulkreadnotice=<p>页面的内容全部被显示在以下的文本框中</p>
anydbmfileerror=<p>无法使用AnyDBM_File 请将\$modifier_dbtype变更为'YukiWikiDB'</p>
table_of_contents=目录

#

top=头部
reload=刷新
help=帮助
searchpage=单词检索
searchbutton=检索
searchand=AND检索
searchor=OR检索

vote_plugin_choice=选择项
vote_plugin_votes=投票

attachbutton=附件
