#
# Resource file
#
deleted=削除しました。
notfound=見つかりません。
invalidname=名前が正しくありません。
editthispage=このページを編集します
admineditthispage=このページを編集します（パスワードが必要）
cantchange=このページは変更できません。
newpagename=ページ新規作成:
touch=タイムスタンプを更新
savebutton=保存する
createbutton=作成する
frozenbutton=凍結する
notfrozenbutton=凍結しない
frozenpassword=パスワード
passworderror=パスワードが誤っています。
changepasswordbutton=パスワード変更
oldpassword=古いパスワード
newpassword=新しいパスワード
newpassword2=新しいパスワード(再入力)
passwordmismatcherror=新しいパスワードが一致していません。
passwordchanged=パスワードを変更しました。
changepassword=パスワード変更
success=完了しました
passwordneeded=ページを凍結するにはパスワードが必要です。
saved=保存しました。
continuereading=次のリンクをたどってください: 
searchthispage=このページを検索
recentchangesbutton=最終更新
indexbutton=一覧
createbutton=新規
editbutton=編集
admineditbutton=凍結
yourname=あなたの名前:
commentbutton=コメント追加
difftitle=差分表示
diffnotice=<ul><li>最後の更新で追加された行は<b class="added">このように</b>表示します。</li><li>最後の更新で削除された行は<s class="deleted">このように</s>表示します。</li></ul><hr />
diffbutton=差分
rssbutton=RSS
previewtitle=プレビュー
previewnotice=<p>以下のプレビューを確認して、よければページ下部のボタンで保存してください。</p><hr />
previewempty=<p>（ページの内容は空です。保存するとこのページは<b>削除</b>されます。）</p>
previewbutton=プレビュー
bulkreadnotice=<p>以下のテキストエリアの中に全ページの内容が展開されています。</p>
anydbmfileerror=<p>AnyDBM_Fileは使えません。\$modifier_dbtypeを'YukiWikiDB'に変更してください。</p>
table_of_contents=目次

#

top=トップ
reload=リロード
help=ヘルプ
searchpage=単語検索
searchbutton=検索
searchand=AND検索
searchor=OR検索

vote_plugin_choice=選択枝
vote_plugin_votes=投票

attachbutton=添付
